********************
*  *  R         *  *
*  *  *  *  * * *  *
*  *     * H       *
*                  *
* R            R   *
*  * R* * *     *  *
*  *    * *     *  *
*  *            *  *
********************