********************
*    ***     R *** *
*  R   *         * *
*             *    *
*  *        *  *   *
*  R      *    *   *
*           R *  * *
*   *  *   ***     *
*  *    H    *  *  *
********************