20 x 10
********************
*** * R     *      *
*         R  *     *
*       **         *
*  *   *  R      * *
*  H       *   *  R*
*     *            *
*             *    *
*  *    R*       ***
********************