20 x 10
********************
*    *      *  R   *
*    *    *****    *
* R            *   *
*      H        *  *
*       *  *       *
* *       *        *
*  * R       * R   *
*   *   *   ***    *
********************