20 x 10
********************
*  *  *          R *
*         *     *  *
*               ** *
* R *     R        *
*  *               *
* *   *      *     *
**     *   R      **
*  H    *          *
********************