20 x 10
********************
*    *  H    *     *
*    *          *  *
*   *     *   R  ***
*   R  *           *
* ***   *          *
* *   R  *         *
*         *    *** *
*   *      *      R*
********************