20 x 10
********************
*    H       *     *
*    *             *
*    *        **   *
*    *    *        *
*    *******    *  *
*   **   *         *
*    *         *   *
*  R * R     * *   *
********************