********************
*  *     H      *  *
*  *            *  *
*  *            *  *
*  *            *  *
*  *     *      *  *
*  *            *  *
*  *            *  *
*  * R       R  *  *
********************