********************
*  *              H*
*  *R *  *  *      *
*R *        *     R*
*  * *     *   *   *
*  **      *  *    *
*       *       *  *
*  *    *      **  *
* R     *    * R   *
********************