********************
*******   ***  H   *
*     *     *      *
* R   *            * 
*      *     *     *
*  *       *       *
*    *  R  ****    *
*     *  ***  *    *
* R    *****     R *
********************