********************
********************
***     *    R    **
***               **
*  *          *    *
*     R *   H      *
* R  *  *    *     *
*  * *      *      *
*  *** **   *  R   *
********************